border_size=1
usage=map

Wo          , Wo          , Wo          , Wo          , Wo          , Wo          , Wo          , Wo          , Wo          , Wo          , Wo          , Wo          , Wo          , Wo          , Wo          , Wo          , Wo          , Wo          , Wo          , Wo          , Wo          , Wo          
Wo          , Wo          , Wo          , Wo          , Wo          , Wo          , Wo          , Wo          , Wo          , Wo          , Wo          , Wo          , Wo          , Wo          , Wo          , Wo          , Wo          , Wo          , Wo          , Wo          , Wo          , Wo          
Wo          , Wo          , Wo          , Wo          , Wo          , Wo          , Wo          , Wo          , Wo          , Wo          , Wo          , Wo          , Wo          , Wo          , Wo          , Wo          , Wo          , Wo          , Wo          , Wo          , Wo          , Wo          
Wo          , Wo          , Wo          , Wo          , Wo          , Wo          , Xu          , Xu          , Re          , Wo          , Wo          , Wo          , Wo          , Wo          , Wo          , Wo          , Wo          , Wo          , Wo          , Wo          , Wo          , Wo          
Wo          , Wo          , Wo          , Wo          , Wo          , Xu          , Re          , Re          , Ce          , Re          , Ur          , Wo          , Wo          , Wo          , Wo          , Wo          , Wo          , Wo          , Wo          , Wo          , Wo          , Wo          
Wo          , Wo          , Wo          , Wo          , Wo          , Xu          , Re          , Ce          , 1 Ke        , Ce          , Re          , Ur          , Ur          , Wo          , Wo          , Wo          , Wo          , Wo          , Wo          , Wo          , Wo          , Wo          
Wo          , Wo          , Wo          , Wo          , Wo          , Xu          , Re          , Ce          , Ce          , Ce          , Re          , Re          , Re          , Ur          , Ur          , Wo          , Wo          , Wo          , Wo          , Wo          , Wo          , Wo          
Wo          , Wo          , Wo          , Wo          , Wo          , Wo          , Wo          , Re          , Uu^Vu       , Re          , Re          , Re          , Xu          , Re          , Re          , Ur          , Ur          , Wo          , Wo          , Wo          , Wo          , Wo          
Wo          , Wo          , Wo          , Wo          , Wo          , Wo          , Wo          , Wo          , Ww^Bw|      , Ur          , Uu^Vu       , Re          , Re          , Re          , Re          , Re          , Re          , Ur          , Xu          , Wo          , Wo          , Wo          
Wo          , Wo          , Wo          , Wo          , Xu          , Wo          , Wo          , Wo          , Ww^Bw|      , Wo          , Ww^Bw|      , Ur          , Ur          , Re          , Re          , Xu          , Re          , Re          , Xu          , Wo          , Wo          , Wo          
Wo          , Wo          , Xu          , Xu          , Re          , Ur          , Ur          , Wo          , Ww^Bw|      , Wo          , Ww^Bw|      , Wo          , Wo          , Ur          , Ur          , Re          , Re          , Re          , Xu          , Wo          , Wo          , Wo          
Wo          , Wo          , Xu          , Re          , Re          , Re          , Re          , Ur          , Uu^Vu       , Wo          , Ww^Bw|      , Wo          , Wo          , Wo          , Wo          , Ur          , Xu          , Xu          , Wo          , Wo          , Wo          , Wo          
Wo          , Wo          , Xu          , Re          , Re          , Re          , Re          , Re          , Re          , Ur          , Uu^Vu       , Wo          , Wo          , Wo          , Wo          , Wo          , Wo          , Wo          , Wo          , Wo          , Wo          , Wo          
Wo          , Wo          , Wo          , Ur          , Ur          , Re          , Re          , Xu          , Re          , Re          , Re          , Ur          , Xu          , Xu          , Xu          , Wo          , Wo          , Wo          , Wo          , Wo          , Wo          , Wo          
Wo          , Wo          , Wo          , Wo          , Wo          , Ur          , Ur          , Re          , Re          , Re          , Xu          , Re          , Re          , Re          , Re          , Xu          , Xu          , Wo          , Wo          , Wo          , Wo          , Wo          
Wo          , Wo          , Wo          , Wo          , Wo          , Wo          , Wo          , Ur          , Ur          , Re          , Re          , Re          , Ce          , Ce          , Ce          , Re          , Xu          , Wo          , Wo          , Wo          , Wo          , Wo          
Wo          , Wo          , Wo          , Wo          , Wo          , Wo          , Wo          , Wo          , Wo          , Ur          , Xu          , Re          , Ce          , 2 Ke        , Ce          , Re          , Xu          , Wo          , Wo          , Wo          , Wo          , Wo          
Wo          , Wo          , Wo          , Wo          , Wo          , Wo          , Wo          , Wo          , Wo          , Wo          , Xu          , Re          , Re          , Ce          , Re          , Uu^Vu       , Xu          , Wo          , Wo          , Wo          , Wo          , Wo          
Wo          , Wo          , Wo          , Wo          , Wo          , Wo          , Wo          , Wo          , Wo          , Wo          , Wo          , Xu          , Xu          , Re          , Xu          , Xu          , Wo          , Wo          , Wo          , Wo          , Wo          , Wo          
Wo          , Wo          , Wo          , Wo          , Wo          , Wo          , Wo          , Wo          , Wo          , Wo          , Wo          , Wo          , Wo          , Xu          , Wo          , Wo          , Wo          , Wo          , Wo          , Wo          , Wo          , Wo          
Wo          , Wo          , Wo          , Wo          , Wo          , Wo          , Wo          , Wo          , Wo          , Wo          , Wo          , Wo          , Wo          , Wo          , Wo          , Wo          , Wo          , Wo          , Wo          , Wo          , Wo          , Wo          
Wo          , Wo          , Wo          , Wo          , Wo          , Wo          , Wo          , Wo          , Wo          , Wo          , Wo          , Wo          , Wo          , Wo          , Wo          , Wo          , Wo          , Wo          , Wo          , Wo          , Wo          , Wo          
