border_size=1
usage=map

Wo          , Wo          , Wo          , Wo          , Wo          , Wo          , Wo          , Wo          , Wo          , Wo          , Wo          , Wo          , Wo          , Wo          , Wo          , Wo          , Wo          , Wo          , Wo          , Wo          , Wo          , Wo          , Wo          , Wo          , Wo          , Wo          
Wo          , Wo          , Wo          , Wo          , Wo          , Wo          , Wo          , Wo          , Wo          , Wo          , Wo          , Wo          , Wo          , Wo          , Wo          , Wo          , Wo          , Wo          , Wo          , Wo          , Wo          , Wo          , Wo          , Wo          , Wo          , Wo          
Wo          , Wo          , Wo          , Wo          , Wo          , Wo          , Wo          , Wo          , Wo          , Wo          , Wo          , Wo          , Wo          , Wo          , Wo          , Wo          , Wo          , Wo          , Wo          , Wo          , Wo          , Wo          , Wo          , Wo          , Wo          , Wo          
Wo          , Wo          , Wo          , Wo          , Wo          , Wo          , Wo          , Wo          , Wo          , Wo          , Wo          , Wo          , Wo          , Wo          , Wo          , Wo          , Wo          , Wo          , Wo          , Wo          , Wo          , Wo          , Wo          , Wo          , Wo          , Wo          
Wo          , Wo          , Wo          , Wo          , Wo          , Wo          , Wo          , Wo          , Wo          , Wo          , Wo          , Wo          , Wo          , Wo          , Wo          , Wo          , Re          , Xu          , Xu          , Wo          , Wo          , Wo          , Wo          , Wo          , Wo          , Wo          
Wo          , Wo          , Wo          , Wo          , Wo          , Wo          , Wo          , Wo          , Wo          , Wo          , Wo          , Wo          , Wo          , Wo          , Rr          , Re          , Ce          , Re          , Re          , Xu          , Wo          , Wo          , Wo          , Wo          , Wo          , Wo          
Wo          , Wo          , Wo          , Wo          , Wo          , Wo          , Wo          , Wo          , Wo          , Wo          , Wo          , Wo          , Rr          , Rr          , Re          , Ce          , 1 Ke        , Ce          , Re          , Xu          , Wo          , Wo          , Wo          , Wo          , Wo          , Wo          
Wo          , Wo          , Wo          , Wo          , Wo          , Wo          , Wo          , Wo          , Wo          , Wo          , Rr          , Rr          , Re          , Re          , Re          , Ce          , Ce          , Ce          , Re          , Xu          , Wo          , Wo          , Wo          , Wo          , Wo          , Wo          
Wo          , Wo          , Wo          , Wo          , Wo          , Wo          , Wo          , Wo          , Rr          , Rr          , Re          , Re          , Xu          , Re          , Re          , Re          , Ss^Vhs      , Re          , Wo          , Wo          , Wo          , Wo          , Wo          , Wo          , Wo          , Wo          
Wo          , Wo          , Wo          , Wo          , Wo          , Wo          , Xu          , Rr          , Re          , Re          , Re          , Re          , Re          , Re          , Ss^Vhs      , Rr          , Ww^Bw|      , Wo          , Wo          , Wo          , Wo          , Wo          , Wo          , Wo          , Wo          , Wo          
Wo          , Wo          , Wo          , Wo          , Wo          , Wo          , Xu          , Re          , Re          , Xu          , Re          , Re          , Rr          , Rr          , Ww^Bw|      , Wo          , Ww^Bw|      , Wo          , Wo          , Wo          , Wo          , Wo          , Wo          , Wo          , Wo          , Wo          
Wo          , Wo          , Wo          , Wo          , Wo          , Wo          , Xu          , Re          , Re          , Re          , Rr          , Rr          , Wo          , Wo          , Ww^Bw|      , Wo          , Ww^Bw|      , Wo          , Wo          , Wo          , Wo          , Wo          , Wo          , Wo          , Wo          , Wo          
Wo          , Wo          , Wo          , Wo          , Wo          , Wo          , Wo          , Xu          , Xu          , Rr          , Wo          , Wo          , Xu          , Wo          , Ww^Bw|      , Wo          , Ww^Bw|      , Wo          , Wo          , Wo          , Wo          , Wo          , Wo          , Wo          , Wo          , Wo          
Wo          , Wo          , Wo          , Wo          , Wo          , Wo          , Wo          , Wo          , Wo          , Wo          , Xu          , Xu          , Re          , Rr          , Ss^Vhs      , Wo          , Ww^Bw|      , Wo          , Wo          , Wo          , Wo          , Wo          , Wo          , Wo          , Wo          , Wo          
Wo          , Wo          , Wo          , Wo          , Xu          , Wo          , Wo          , Wo          , Wo          , Wo          , Xu          , Re          , Re          , Re          , Re          , Rr          , Ss^Vhs      , Wo          , Wo          , Wo          , Wo          , Wo          , Wo          , Wo          , Wo          , Wo          
Wo          , Wo          , Xu          , Xu          , Re          , Xu          , Xu          , Wo          , Wo          , Wo          , Xu          , Re          , Re          , Xu          , Re          , Re          , Re          , Rr          , Rr          , Wo          , Wo          , Wo          , Wo          , Wo          , Wo          , Wo          
Wo          , Wo          , Rr          , Re          , Re          , Re          , Rr          , Wo          , Wo          , Wo          , Ww^Bw/      , Ss^Vhs      , Rr          , Re          , Re          , Re          , Xu          , Re          , Re          , Re          , Re          , Wo          , Wo          , Wo          , Wo          , Wo          
Wo          , Wo          , Rr          , Re          , Xu          , Re          , Rr          , Wo          , Ww^Bw/      , Ww^Bw/      , Wo          , Wo          , Ww^Bw/      , Ss^Vhs      , Rr          , Re          , Re          , Re          , Ce          , Ce          , Ce          , Re          , Xu          , Wo          , Wo          , Wo          
Wo          , Wo          , Rr          , Re          , Re          , Re          , Ss^Vhs      , Ww^Bw/      , Wo          , Wo          , Ww^Bw/      , Ww^Bw/      , Wo          , Wo          , Wo          , Rr          , Rr          , Re          , Ce          , 3 Ke        , Ce          , Re          , Xu          , Wo          , Wo          , Wo          
Wo          , Wo          , Re          , Re          , Ce          , Re          , Re          , Wo          , Ww^Bw/      , Ww^Bw/      , Wo          , Wo          , Wo          , Wo          , Wo          , Wo          , Wo          , Re          , Re          , Ce          , Re          , Re          , Xu          , Wo          , Wo          , Wo          
Wo          , Wo          , Re          , Ce          , 2 Ke        , Ce          , Ss^Vhs      , Ww^Bw/      , Wo          , Wo          , Wo          , Wo          , Wo          , Wo          , Wo          , Wo          , Wo          , Wo          , Wo          , Re          , Xu          , Xu          , Wo          , Wo          , Wo          , Wo          
Wo          , Wo          , Re          , Ce          , Ce          , Ce          , Re          , Wo          , Wo          , Wo          , Wo          , Wo          , Wo          , Wo          , Wo          , Wo          , Wo          , Wo          , Wo          , Wo          , Wo          , Wo          , Wo          , Wo          , Wo          , Wo          
Wo          , Wo          , Xu          , Re          , Re          , Re          , Xu          , Wo          , Wo          , Wo          , Wo          , Wo          , Wo          , Wo          , Wo          , Wo          , Wo          , Wo          , Wo          , Wo          , Wo          , Wo          , Wo          , Wo          , Wo          , Wo          
Wo          , Wo          , Wo          , Xu          , Xu          , Xu          , Wo          , Wo          , Wo          , Wo          , Wo          , Wo          , Wo          , Wo          , Wo          , Wo          , Wo          , Wo          , Wo          , Wo          , Wo          , Wo          , Wo          , Wo          , Wo          , Wo          
Wo          , Wo          , Wo          , Wo          , Wo          , Wo          , Wo          , Wo          , Wo          , Wo          , Wo          , Wo          , Wo          , Wo          , Wo          , Wo          , Wo          , Wo          , Wo          , Wo          , Wo          , Wo          , Wo          , Wo          , Wo          , Wo          
Wo          , Wo          , Wo          , Wo          , Wo          , Wo          , Wo          , Wo          , Wo          , Wo          , Wo          , Wo          , Wo          , Wo          , Wo          , Wo          , Wo          , Wo          , Wo          , Wo          , Wo          , Wo          , Wo          , Wo          , Wo          , Wo          
Wo          , Wo          , Wo          , Wo          , Wo          , Wo          , Wo          , Wo          , Wo          , Wo          , Wo          , Wo          , Wo          , Wo          , Wo          , Wo          , Wo          , Wo          , Wo          , Wo          , Wo          , Wo          , Wo          , Wo          , Wo          , Wo          
